names ,ai,alg,entur,stats,java,marks
A,46,42,43,44,39,214
B,50,45,42,41,39,217
C,15,14,16,18,19,82
D,41,29,49,42,39,200
E,50,36,38,45,21,190
F,2,5,8,7,10,32
G,45,44,29,50,50,218
H,41,42,46,41,40,210
I,39,35,37,36,31,178
J,2,2,2,3,5,14
K,10,0,28,40,21,99
L,19,17,18,15,10,79
